aa  AA
ae  AE
ah	AH
ao	AO
aw	AW
ay	AY
b	B
ch	CH
d	D
dh	DH
eh	EH
er	ER
ey	EY
f	F
g	G
hh	HH
ih	IH
iy	IY
jh	JH
k	K
l	L
m	M
n	N
ng	NG
ow	OW
oy	OY
p	P
r	R
s	S
sh	SH
sil	SIL
ss	S
t	T
th	TH
uh	UH
uw	UW
v	V
w	W
y	Y
z	Z
zh	ZH